1111111111111
1C01111100001
10010001C0101
1P0101E1111C1
100101C000001
1C00010000C11
1111111111111