1111111111111
1C01111100001
1001000100001
1P0001E0000C1
10000C0000001
1000000000C01
1111111111111