111111111111\n
1P0000000001\n
1E0000000001\n
1C0000000001\n
100000000001\n
111111111111\0